M1_pr_low_quality	/minimax-dialogue/data/users/walker/one_cpu/code/stage3/prs_renders_deduped/with_images/pr_low_quality_fix/
M1_pr_high_quality	/minimax-dialogue/data/users/walker/one_cpu/code/stage3/prs_renders_deduped/with_images/pr_high_quality_fix/
M1_issues	/minimax-dialogue/data/users/walker/one_cpu/code/stage3/issues_renders_deduped/with_images_fix/
notebook_m1_process_mask_just_spt	/minimax-dialogue/data/users/anda/data_inprocess/m2_code/notebook/stage2_2_filter_build_mask_just_special_token_minhash_dedup/notebook_mask_just_spt/intra/deduplicated_output
cc-math-5	/minimax-dialogue/data/users/yuban/cc_code_math/quality_classifier/filtered/math/output/5
cc-math-4	/minimax-dialogue/data/users/yuban/cc_code_math/quality_classifier/filtered/math/output/4/
cc-math-3	/minimax-dialogue/data/users/yuban/cc_code_math/quality_classifier/filtered/math/output/3
cc-math-2	/minimax-dialogue/data/users/yuban/cc_code_math/quality_classifier/filtered/math/output/2
cc-code-5	/minimax-dialogue/data/users/yuban/cc_code_math/quality_classifier/filtered/code/output/5
cc-code-4	/minimax-dialogue/data/users/yuban/cc_code_math/quality_classifier/filtered/code/output/4
cc-code-3	/minimax-dialogue/data/users/yuban/cc_code_math/quality_classifier/filtered/code/output/3
xiaoyuan_math	/minimax-dialogue/airflow/data_pipeline/pretrain/cc_pipeline/domain_bucket/xiaoyuan_v3_all/en/math_output
xiaoyuan_code	/minimax-dialogue/airflow/data_pipeline/pretrain/cc_pipeline/domain_bucket/xiaoyuan_v3_all/en/code_output
xiaoyuan_stem_EHQ	/minimax-dialogue/airflow/data_pipeline/pretrain/cc_pipeline/domain_bucket/xiaoyuan_v3_all/en/stem_output/bucket_EHQ
xiaoyuan_stem_HQ	/minimax-dialogue/airflow/data_pipeline/pretrain/cc_pipeline/domain_bucket/xiaoyuan_v3_all/en/stem_output/bucket_HQ
xiaoyuan_stem_MH	/minimax-dialogue/airflow/data_pipeline/pretrain/cc_pipeline/domain_bucket/xiaoyuan_v3_all/en/stem_output/bucket_MH
xiaoyuan_stem_ML	/minimax-dialogue/airflow/data_pipeline/pretrain/cc_pipeline/domain_bucket/xiaoyuan_v3_all/en/stem_output/bucket_ML
xiaoyuan_stem_LQ	/minimax-dialogue/airflow/data_pipeline/pretrain/cc_pipeline/domain_bucket/xiaoyuan_v3_all/en/stem_output/bucket_LQ
xiaoyuan_stem_ELQ	/minimax-dialogue/airflow/data_pipeline/pretrain/cc_pipeline/domain_bucket/xiaoyuan_v3_all/en/stem_output/bucket_ELQ
xiaoyuan_general_EHQ	/minimax-dialogue/airflow/data_pipeline/pretrain/cc_pipeline/domain_bucket/xiaoyuan_v3_all/en/general_output/bucket_EHQ
xiaoyuan_general_HQ	/minimax-dialogue/airflow/data_pipeline/pretrain/cc_pipeline/domain_bucket/xiaoyuan_v3_all/en/general_output/bucket_HQ
xiaoyuan_general_MH	/minimax-dialogue/airflow/data_pipeline/pretrain/cc_pipeline/domain_bucket/xiaoyuan_v3_all/en/general_output/bucket_MH
xiaoyuan_general_ML	/minimax-dialogue/airflow/data_pipeline/pretrain/cc_pipeline/domain_bucket/xiaoyuan_v3_all/en/general_output/bucket_ML
xiaoyuan_general_LQ	/minimax-dialogue/airflow/data_pipeline/pretrain/cc_pipeline/domain_bucket/xiaoyuan_v3_all/en/general_output/bucket_LQ
xiaoyuan_general_ELQ	/minimax-dialogue/airflow/data_pipeline/pretrain/cc_pipeline/domain_bucket/xiaoyuan_v3_all/en/general_output/bucket_ELQ
ao3	/minimax-dialogue/raw_data/m1_small_sources_dedup/pretrain_data_reward_merge_0307/ao3
dianya_huabaen	/minimax-dialogue/raw_data/pretrain_data_reward_merge_0307/dianya_huaben/
math_proof_pile	/minimax-dialogue/raw_data/kawendixu/inline_dedup_results/math_proof_pile/mathpile_document_unique_xsource_dedup/unique,/minimax-dialogue/raw_data/kawendixu/inline_dedup_results/math_proof_pile/proof_pile_2_unique_xsource_dedup/unique
stackexchange_1q1a	/minimax-dialogue/data/users/anda/data_inprocess/m2_xiaoyuan/stackexchange/stage4_concat_1q1a_new_dataload
stackexchange_1qNa	/minimax-dialogue/data/users/anda/data_inprocess/m2_xiaoyuan/stackexchange/stag4_concat_1qNa/output
K12_guihai	/minimax-dialogue/data/users/shenxia/M2-mini-June/Tiku/k12_guihai/4_cross_minhash_and_chinese_clean/output
K12-2	/minimax-dialogue/data/users/shenxia/M2-mini-June/Tiku/k12/4_reserve_minhash/deduplicated_output
m2_AllTiku	/minimax-dialogue/data/users/shenxia/M2-mini-June/AllTiku/minhash/deduplicated_output
qa_sch1_general_EHQ	/minimax-dialogue/data/users/shenxia/M2-mini-June/multi-qa-concat/xiaoyuanqa_zonghe_imgs/buckets_img_undownload/sch1/*/general_output/bucket_EHQ/
qa_sch1_general_HQ	/minimax-dialogue/data/users/shenxia/M2-mini-June/multi-qa-concat/xiaoyuanqa_zonghe_imgs/buckets_img_undownload/sch1/*/general_output/bucket_HQ/
qa_sch1_general_MH	/minimax-dialogue/data/users/shenxia/M2-mini-June/multi-qa-concat/xiaoyuanqa_zonghe_imgs/buckets_img_undownload/sch1/*/general_output/bucket_MH/
qa_sch1_general_ML	/minimax-dialogue/data/users/shenxia/M2-mini-June/multi-qa-concat/xiaoyuanqa_zonghe_imgs/buckets_img_undownload/sch1/*/general_output/bucket_ML/
qa_sch1_general_LQ	/minimax-dialogue/data/users/shenxia/M2-mini-June/multi-qa-concat/xiaoyuanqa_zonghe_imgs/buckets_img_undownload/sch1/*/general_output/bucket_LQ/
qa_sch1_general_ELQ	/minimax-dialogue/data/users/shenxia/M2-mini-June/multi-qa-concat/xiaoyuanqa_zonghe_imgs/buckets_img_undownload/sch1/*/general_output/bucket_ELQ/
qa_sch1_stem_EHQ	/minimax-dialogue/data/users/shenxia/M2-mini-June/multi-qa-concat/xiaoyuanqa_zonghe_imgs/buckets_img_undownload/sch1/*/stem_output/bucket_EHQ/
qa_sch1_stem_ELQ	/minimax-dialogue/data/users/shenxia/M2-mini-June/multi-qa-concat/xiaoyuanqa_zonghe_imgs/buckets_img_undownload/sch1/*/stem_output/bucket_ELQ/
sch1_stem_HQ	/minimax-dialogue/data/users/shenxia/M2-mini-June/multi-qa-concat/xiaoyuanqa_zonghe_imgs/buckets_img_undownload/sch1/*/stem_output/bucket_HQ/
qa_sch1_stem_LQ	/minimax-dialogue/data/users/shenxia/M2-mini-June/multi-qa-concat/xiaoyuanqa_zonghe_imgs/buckets_img_undownload/sch1/*/stem_output/bucket_LQ/
qa_sch1_stem_MH	/minimax-dialogue/data/users/shenxia/M2-mini-June/multi-qa-concat/xiaoyuanqa_zonghe_imgs/buckets_img_undownload/sch1/*/stem_output/bucket_MH/
qa_sch1_stem_ML	/minimax-dialogue/data/users/shenxia/M2-mini-June/multi-qa-concat/xiaoyuanqa_zonghe_imgs/buckets_img_undownload/sch1/*/stem_output/bucket_ML/
qa_sch2_general_EHQ	/minimax-dialogue/data/users/shenxia/M2-mini-June/multi-qa-concat/xiaoyuanqa_zonghe_imgs/buckets_img_undownload/sch2/*/general_output/bucket_EHQ/
qa_sch2_general_HQ	/minimax-dialogue/data/users/shenxia/M2-mini-June/multi-qa-concat/xiaoyuanqa_zonghe_imgs/buckets_img_undownload/sch2/*/general_output/bucket_HQ/
qa_sch2_general_MH	/minimax-dialogue/data/users/shenxia/M2-mini-June/multi-qa-concat/xiaoyuanqa_zonghe_imgs/buckets_img_undownload/sch2/*/general_output/bucket_MH/
qa_sch2_general_ML	/minimax-dialogue/data/users/shenxia/M2-mini-June/multi-qa-concat/xiaoyuanqa_zonghe_imgs/buckets_img_undownload/sch2/*/general_output/bucket_ML/
qa_sch2_general_LQ	/minimax-dialogue/data/users/shenxia/M2-mini-June/multi-qa-concat/xiaoyuanqa_zonghe_imgs/buckets_img_undownload/sch2/*/general_output/bucket_LQ/
qa_sch2_general_ELQ	/minimax-dialogue/data/users/shenxia/M2-mini-June/multi-qa-concat/xiaoyuanqa_zonghe_imgs/buckets_img_undownload/sch2/*/general_output/bucket_ELQ/
qa_sch2_stem_EHQ	/minimax-dialogue/data/users/shenxia/M2-mini-June/multi-qa-concat/xiaoyuanqa_zonghe_imgs/buckets_img_undownload/sch2/*/stem_output/bucket_EHQ/
qa_sch2_stem_HQ	/minimax-dialogue/data/users/shenxia/M2-mini-June/multi-qa-concat/xiaoyuanqa_zonghe_imgs/buckets_img_undownload/sch2/*/stem_output/bucket_HQ/
qa_sch2_stem_MH	/minimax-dialogue/data/users/shenxia/M2-mini-June/multi-qa-concat/xiaoyuanqa_zonghe_imgs/buckets_img_undownload/sch2/*/stem_output/bucket_MH/
qa_sch2_stem_ML	/minimax-dialogue/data/users/shenxia/M2-mini-June/multi-qa-concat/xiaoyuanqa_zonghe_imgs/buckets_img_undownload/sch2/*/stem_output/bucket_ML/
qa_sch2_stem_LQ	/minimax-dialogue/data/users/shenxia/M2-mini-June/multi-qa-concat/xiaoyuanqa_zonghe_imgs/buckets_img_undownload/sch2/*/stem_output/bucket_LQ/
qa_sch2_stem_ELQ	/minimax-dialogue/data/users/shenxia/M2-mini-June/multi-qa-concat/xiaoyuanqa_zonghe_imgs/buckets_img_undownload/sch2/*/stem_output/bucket_ELQ/
qa_sch3_general_EHQ	/minimax-dialogue/data/users/shenxia/M2-mini-June/multi-qa-concat/xiaoyuanqa_zonghe_imgs/buckets_img_undownload/sch3/*/general_output/bucket_EHQ/
qa_sch3_general_HQ	/minimax-dialogue/data/users/shenxia/M2-mini-June/multi-qa-concat/xiaoyuanqa_zonghe_imgs/buckets_img_undownload/sch3/*/general_output/bucket_HQ/
qa_sch3_general_MH	/minimax-dialogue/data/users/shenxia/M2-mini-June/multi-qa-concat/xiaoyuanqa_zonghe_imgs/buckets_img_undownload/sch3/*/general_output/bucket_MH/
qa_sch3_general_ML	/minimax-dialogue/data/users/shenxia/M2-mini-June/multi-qa-concat/xiaoyuanqa_zonghe_imgs/buckets_img_undownload/sch3/*/general_output/bucket_ML/
qa_sch3_general_LQ	/minimax-dialogue/data/users/shenxia/M2-mini-June/multi-qa-concat/xiaoyuanqa_zonghe_imgs/buckets_img_undownload/sch3/*/general_output/bucket_LQ/
qa_sch3_general_ELQ	/minimax-dialogue/data/users/shenxia/M2-mini-June/multi-qa-concat/xiaoyuanqa_zonghe_imgs/buckets_img_undownload/sch3/*/general_output/bucket_ELQ/
qa_sch3_stem_EHQ	/minimax-dialogue/data/users/shenxia/M2-mini-June/multi-qa-concat/xiaoyuanqa_zonghe_imgs/buckets_img_undownload/sch3/*/stem_output/bucket_EHQ/
qa_sch3_stem_HQ	/minimax-dialogue/data/users/shenxia/M2-mini-June/multi-qa-concat/xiaoyuanqa_zonghe_imgs/buckets_img_undownload/sch3/*/stem_output/bucket_HQ/
qa_sch3_stem_MH	/minimax-dialogue/data/users/shenxia/M2-mini-June/multi-qa-concat/xiaoyuanqa_zonghe_imgs/buckets_img_undownload/sch3/*/stem_output/bucket_MH/
qa_sch3_stem_ML	/minimax-dialogue/data/users/shenxia/M2-mini-June/multi-qa-concat/xiaoyuanqa_zonghe_imgs/buckets_img_undownload/sch3/*/stem_output/bucket_ML/
qa_sch3_stem_LQ	/minimax-dialogue/data/users/shenxia/M2-mini-June/multi-qa-concat/xiaoyuanqa_zonghe_imgs/buckets_img_undownload/sch3/*/stem_output/bucket_LQ/
qa_sch3_stem_ELQ	/minimax-dialogue/data/users/shenxia/M2-mini-June/multi-qa-concat/xiaoyuanqa_zonghe_imgs/buckets_img_undownload/sch3/*/stem_output/bucket_ELQ/
reddit_general_EHQ	/minimax-dialogue/data/users/shenxia/M2-mini-June/multi-qa-concat/reddit_new/3_buckets/*/general_output/bucket_EHQ/
reddit_general_HQ	/minimax-dialogue/data/users/shenxia/M2-mini-June/multi-qa-concat/reddit_new/3_buckets/*/general_output/bucket_HQ/
reddit_general_MH	/minimax-dialogue/data/users/shenxia/M2-mini-June/multi-qa-concat/reddit_new/3_buckets/*/general_output/bucket_MH/
reddit_general_ML	/minimax-dialogue/data/users/shenxia/M2-mini-June/multi-qa-concat/reddit_new/3_buckets/*/general_output/bucket_ML/
reddit_general_LQ	/minimax-dialogue/data/users/shenxia/M2-mini-June/multi-qa-concat/reddit_new/3_buckets/*/general_output/bucket_LQ/
reddit_general_ELQ	/minimax-dialogue/data/users/shenxia/M2-mini-June/multi-qa-concat/reddit_new/3_buckets/*/general_output/bucket_ELQ/
reddit_stem_EHQ	/minimax-dialogue/data/users/shenxia/M2-mini-June/multi-qa-concat/reddit_new/3_buckets/*/stem_output/bucket_EHQ/
reddit_stem_HQ	/minimax-dialogue/data/users/shenxia/M2-mini-June/multi-qa-concat/reddit_new/3_buckets/*/stem_output/bucket_HQ/
reddit_stem_MH	/minimax-dialogue/data/users/shenxia/M2-mini-June/multi-qa-concat/reddit_new/3_buckets/*/stem_output/bucket_MH/
reddit_stem_ML	/minimax-dialogue/data/users/shenxia/M2-mini-June/multi-qa-concat/reddit_new/3_buckets/*/stem_output/bucket_ML/
reddit_stem_LQ	/minimax-dialogue/data/users/shenxia/M2-mini-June/multi-qa-concat/reddit_new/3_buckets/*/stem_output/bucket_LQ/
pdf_stem_EHQ	/minimax-dialogue/data/users/beihai/M2_data/sources/pdf_hq/reward_filter/output/stem/EHQ/split_*/*/*.jsonl,/minimax-dialogue/data/users/beihai/M2_data/sources/pdf_lq/reward_filter/output/stem/EHQ/split_*/*/*.jsonl,/minimax-dialogue/data/users/beihai/M2_data/sources/institution_book/reward_filter/output/stem/EHQ/split_*/*/*.jsonl
pdf_stem_HQ	/minimax-dialogue/data/users/beihai/M2_data/sources/pdf_hq/reward_filter/output/stem/HQ/split_*/*/*.jsonl,/minimax-dialogue/data/users/beihai/M2_data/sources/pdf_lq/reward_filter/output/stem/HQ/split_*/*/*.jsonl,/minimax-dialogue/data/users/beihai/M2_data/sources/institution_book/reward_filter/output/stem/HQ/split_*/*/*.jsonl
pdf_stem_MH	/minimax-dialogue/data/users/beihai/M2_data/sources/pdf_hq/reward_filter/output/stem/MH/split_*/*/*.jsonl,/minimax-dialogue/data/users/beihai/M2_data/sources/pdf_lq/reward_filter/output/stem/MH/split_*/*/*.jsonl,/minimax-dialogue/data/users/beihai/M2_data/sources/institution_book/reward_filter/output/stem/MH/split_*/*/*.jsonl
pdf_stem_ML	/minimax-dialogue/data/users/beihai/M2_data/sources/pdf_hq/reward_filter/output/stem/ML/split_*/*/*.jsonl,/minimax-dialogue/data/users/beihai/M2_data/sources/pdf_lq/reward_filter/output/stem/ML/split_*/*/*.jsonl,/minimax-dialogue/data/users/beihai/M2_data/sources/institution_book/reward_filter/output/stem/ML/split_*/*/*.jsonl
pdf_stem_LQ	/minimax-dialogue/data/users/beihai/M2_data/sources/pdf_hq/reward_filter/output/stem/LQ/split_*/*/*.jsonl,/minimax-dialogue/data/users/beihai/M2_data/sources/pdf_lq/reward_filter/output/stem/LQ/split_*/*/*.jsonl,/minimax-dialogue/data/users/beihai/M2_data/sources/institution_book/reward_filter/output/stem/LQ/split_*/*/*.jsonl
pdf_stem_ELQ	/minimax-dialogue/data/users/beihai/M2_data/sources/pdf_hq/reward_filter/output/stem/ELQ/split_*/*/*.jsonl,/minimax-dialogue/data/users/beihai/M2_data/sources/pdf_lq/reward_filter/output/stem/ELQ/split_*/*/*.jsonl,/minimax-dialogue/data/users/beihai/M2_data/sources/institution_book/reward_filter/output/stem/ELQ/split_*/*/*.jsonl
pdf_general_EHQ	/minimax-dialogue/data/users/beihai/M2_data/sources/pdf_hq/reward_filter/output/general/EHQ/split_*/*/*.jsonl,/minimax-dialogue/data/users/beihai/M2_data/sources/pdf_lq/reward_filter/output/general/EHQ/split_*/*/*.jsonl,/minimax-dialogue/data/users/beihai/M2_data/sources/institution_book/reward_filter/output/general/EHQ/split_*/*/*.jsonl
pdf_general_HQ	/minimax-dialogue/data/users/beihai/M2_data/sources/pdf_hq/reward_filter/output/general/HQ/split_*/*/*.jsonl,/minimax-dialogue/data/users/beihai/M2_data/sources/pdf_lq/reward_filter/output/general/HQ/split_*/*/*.jsonl,/minimax-dialogue/data/users/beihai/M2_data/sources/institution_book/reward_filter/output/general/HQ/split_*/*/*.jsonl
pdf_general_MH	/minimax-dialogue/data/users/beihai/M2_data/sources/pdf_hq/reward_filter/output/general/MH/split_*/*/*.jsonl,/minimax-dialogue/data/users/beihai/M2_data/sources/pdf_lq/reward_filter/output/general/MH/split_*/*/*.jsonl,/minimax-dialogue/data/users/beihai/M2_data/sources/institution_book/reward_filter/output/general/MH/split_*/*/*.jsonl
pdf_general_ML	/minimax-dialogue/data/users/beihai/M2_data/sources/pdf_hq/reward_filter/output/general/MML/split_*/*/*.jsonl,/minimax-dialogue/data/users/beihai/M2_data/sources/pdf_lq/reward_filter/output/general/ML/split_*/*/*.jsonl,/minimax-dialogue/data/users/beihai/M2_data/sources/institution_book/reward_filter/output/general/ML/split_*/*/*.jsonl
pdf_general_LQ	/minimax-dialogue/data/users/beihai/M2_data/sources/pdf_hq/reward_filter/output/split_*/*/*.jsonl,/minimax-dialogue/data/users/beihai/M2_data/sources/pdf_lq/reward_filter/output/general/LQ/split_*/*/*.jsonl,/minimax-dialogue/data/users/beihai/M2_data/sources/institution_book/reward_filter/output/general/LQ/split_*/*/*.jsonl
CC_en_general_EHQ	/minimax-dialogue/data/users/Dan/code/projects/m2_distribution/data/m2_cc_with_code_math_after_clean/plain/batch_*/en/general_output/bucket_EHQ/*.jsonl
CC_en_general_HQ	/minimax-dialogue/data/users/Dan/code/projects/m2_distribution/data/m2_cc_with_code_math_after_clean/plain/batch_*/en/general_output/bucket_HQ/*.jsonl
CC_en_general_MH	/minimax-dialogue/data/users/Dan/code/projects/m2_distribution/data/m2_cc_with_code_math_after_clean/plain/batch_*/en/general_output/bucket_MH/*.jsonl
CC_en_general_ML	/minimax-dialogue/data/users/Dan/code/projects/m2_distribution/data/m2_cc_with_code_math_after_clean/plain/batch_*/en/general_output/bucket_ML/*.jsonl
CC_en_general_LQ	/minimax-dialogue/data/users/Dan/code/projects/m2_distribution/data/m2_cc_with_code_math_after_clean/plain/batch_*/en/general_output/bucket_LQ/*.jsonl
CC_en_general_ELQ	/minimax-dialogue/data/users/Dan/code/projects/m2_distribution/data/m2_cc_with_code_math_after_clean/plain/batch_*/en/general_output/bucket_ELQ/*.jsonl
CC_en_stem_EHQ	/minimax-dialogue/data/users/Dan/code/projects/m2_distribution/data/m2_cc_with_code_math_after_clean/plain/batch_*/en/stem_output/bucket_EHQ/*.jsonl
CC_en_stem_HQ	/minimax-dialogue/data/users/Dan/code/projects/m2_distribution/data/m2_cc_with_code_math_after_clean/plain/batch_*/en/stem_output/bucket_HQ/*.jsonl
CC_en_stem_MH	/minimax-dialogue/data/users/Dan/code/projects/m2_distribution/data/m2_cc_with_code_math_after_clean/plain/batch_*/en/stem_output/bucket_MH/*.jsonl
CC_en_stem_ML	/minimax-dialogue/data/users/Dan/code/projects/m2_distribution/data/m2_cc_with_code_math_after_clean/plain/batch_*/en/stem_output/bucket_ML/*.jsonl
CC_en_stem_LQ	/minimax-dialogue/data/users/Dan/code/projects/m2_distribution/data/m2_cc_with_code_math_after_clean/plain/batch_*/en/stem_output/bucket_LQ/*.jsonl
CC_en_stem_ELQ	/minimax-dialogue/data/users/Dan/code/projects/m2_distribution/data/m2_cc_with_code_math_after_clean/plain/batch_*/en/stem_output/bucket_ELQ/*.jsonl
CC_ml_general_EHQ	/minimax-dialogue/data/users/Dan/code/projects/m2_distribution/data/m2_cc_with_code_math_after_clean/plain/batch_*/ml/general_output/bucket_EHQ/*.jsonl
CC_ml_general_HQ	/minimax-dialogue/data/users/Dan/code/projects/m2_distribution/data/m2_cc_with_code_math_after_clean/plain/batch_*/ml/general_output/bucket_HQ/*.jsonl
CC_ml_general_MH	/minimax-dialogue/data/users/Dan/code/projects/m2_distribution/data/m2_cc_with_code_math_after_clean/plain/batch_*/ml/general_output/bucket_MH/*.jsonl
CC_ml_general_ML	/minimax-dialogue/data/users/Dan/code/projects/m2_distribution/data/m2_cc_with_code_math_after_clean/plain/batch_*/ml/general_output/bucket_ML/*.jsonl
CC_ml_general_LQ	/minimax-dialogue/data/users/Dan/code/projects/m2_distribution/data/m2_cc_with_code_math_after_clean/plain/batch_*/ml/general_output/bucket_LQ/*.jsonl
CC_ml_general_ELQ	/minimax-dialogue/data/users/Dan/code/projects/m2_distribution/data/m2_cc_with_code_math_after_clean/plain/batch_*/ml/general_output/bucket_ELQ/*.jsonl
CC_ml_stem_EHQ	/minimax-dialogue/data/users/Dan/code/projects/m2_distribution/data/m2_cc_with_code_math_after_clean/plain/batch_*/ml/stem_output/bucket_EHQ/*.jsonl
CC_ml_stem_HQ	/minimax-dialogue/data/users/Dan/code/projects/m2_distribution/data/m2_cc_with_code_math_after_clean/plain/batch_*/ml/stem_output/bucket_HQ/*.jsonl
CC_ml_stem_MH	/minimax-dialogue/data/users/Dan/code/projects/m2_distribution/data/m2_cc_with_code_math_after_clean/plain/batch_*/ml/stem_output/bucket_MH/*.jsonl
CC_ml_stem_ML	/minimax-dialogue/data/users/Dan/code/projects/m2_distribution/data/m2_cc_with_code_math_after_clean/plain/batch_*/ml/stem_output/bucket_ML/*.jsonl
CC_ml_stem_LQ	/minimax-dialogue/data/users/Dan/code/projects/m2_distribution/data/m2_cc_with_code_math_after_clean/plain/batch_*/ml/stem_output/bucket_LQ/*.jsonl
CC_ml_stem_ELQ	/minimax-dialogue/data/users/Dan/code/projects/m2_distribution/data/m2_cc_with_code_math_after_clean/plain/batch_*/ml/stem_output/bucket_ELQ/*.jsonl
CC_other_general_EHQ	/minimax-dialogue/data/users/Dan/code/projects/m2_distribution/data/m2_cc_with_code_math_after_clean/plain/batch_*/other/general_output/bucket_EHQ/*.jsonl
CC_other_general_HQ	/minimax-dialogue/data/users/Dan/code/projects/m2_distribution/data/m2_cc_with_code_math_after_clean/plain/batch_*/other/general_output/bucket_HQ/*.jsonl
CC_other_general_MH	/minimax-dialogue/data/users/Dan/code/projects/m2_distribution/data/m2_cc_with_code_math_after_clean/plain/batch_*/other/general_output/bucket_MH/*.jsonl
CC_other_general_ML	/minimax-dialogue/data/users/Dan/code/projects/m2_distribution/data/m2_cc_with_code_math_after_clean/plain/batch_*/other/general_output/bucket_ML/*.jsonl
CC_other_general_LQ	/minimax-dialogue/data/users/Dan/code/projects/m2_distribution/data/m2_cc_with_code_math_after_clean/plain/batch_*/other/general_output/bucket_LQ/*.jsonl
CC_other_general_ELQ	/minimax-dialogue/data/users/Dan/code/projects/m2_distribution/data/m2_cc_with_code_math_after_clean/plain/batch_*/other/general_output/bucket_ELQ/*.jsonl
CC_other_stem_EHQ	/minimax-dialogue/data/users/Dan/code/projects/m2_distribution/data/m2_cc_with_code_math_after_clean/plain/batch_*/other/stem_output/bucket_EHQ/*.jsonl
CC_other_stem_HQ	/minimax-dialogue/data/users/Dan/code/projects/m2_distribution/data/m2_cc_with_code_math_after_clean/plain/batch_*/other/stem_output/bucket_HQ/*.jsonl
CC_other_stem_MH	/minimax-dialogue/data/users/Dan/code/projects/m2_distribution/data/m2_cc_with_code_math_after_clean/plain/batch_*/other/stem_output/bucket_MH/*.jsonl
CC_other_stem_ML	/minimax-dialogue/data/users/Dan/code/projects/m2_distribution/data/m2_cc_with_code_math_after_clean/plain/batch_*/other/stem_output/bucket_ML/*.jsonl
CC_other_stem_LQ	/minimax-dialogue/data/users/Dan/code/projects/m2_distribution/data/m2_cc_with_code_math_after_clean/plain/batch_*/other/stem_output/bucket_LQ/*.jsonl
CC_other_stem_ELQ	/minimax-dialogue/data/users/Dan/code/projects/m2_distribution/data/m2_cc_with_code_math_after_clean/plain/batch_*/other/stem_output/bucket_ELQ/*.jsonl
CC_zh_general_EHQ	/minimax-dialogue/data/users/Dan/code/projects/m2_distribution/data/m2_cc_with_code_math_after_clean/plain/batch_*/zh/general_output/bucket_EHQ/*.jsonl
CC_zh_general_HQ	/minimax-dialogue/data/users/Dan/code/projects/m2_distribution/data/m2_cc_with_code_math_after_clean/plain/batch_*/zh/general_output/bucket_HQ/*.jsonl
CC_zh_general_MH	/minimax-dialogue/data/users/Dan/code/projects/m2_distribution/data/m2_cc_with_code_math_after_clean/plain/batch_*/zh/general_output/bucket_MH/*.jsonl
CC_zh_general_ML	/minimax-dialogue/data/users/Dan/code/projects/m2_distribution/data/m2_cc_with_code_math_after_clean/plain/batch_*/zh/general_output/bucket_ML/*.jsonl
CC_zh_general_LQ	/minimax-dialogue/data/users/Dan/code/projects/m2_distribution/data/m2_cc_with_code_math_after_clean/plain/batch_*/zh/general_output/bucket_LQ/*.jsonl
CC_zh_general_ELQ	/minimax-dialogue/data/users/Dan/code/projects/m2_distribution/data/m2_cc_with_code_math_after_clean/plain/batch_*/zh/general_output/bucket_ELQ/*.jsonl
CC_zh_stem_EHQ	/minimax-dialogue/data/users/Dan/code/projects/m2_distribution/data/m2_cc_with_code_math_after_clean/plain/batch_*/zh/stem_output/bucket_EHQ/*.jsonl
CC_zh_stem_HQ	/minimax-dialogue/data/users/Dan/code/projects/m2_distribution/data/m2_cc_with_code_math_after_clean/plain/batch_*/zh/stem_output/bucket_HQ/*.jsonl
CC_zh_stem_MH	/minimax-dialogue/data/users/Dan/code/projects/m2_distribution/data/m2_cc_with_code_math_after_clean/plain/batch_*/zh/stem_output/bucket_MH/*.jsonl
CC_zh_stem_ML	/minimax-dialogue/data/users/Dan/code/projects/m2_distribution/data/m2_cc_with_code_math_after_clean/plain/batch_*/zh/stem_output/bucket_ML/*.jsonl
CC_zh_stem_LQ	/minimax-dialogue/data/users/Dan/code/projects/m2_distribution/data/m2_cc_with_code_math_after_clean/plain/batch_*/zh/stem_output/bucket_LQ/*.jsonl
CC_zh_stem_ELQ	/minimax-dialogue/data/users/Dan/code/projects/m2_distribution/data/m2_cc_with_code_math_after_clean/plain/batch_*/zh/stem_output/bucket_ELQ/*.jsonl
CC-bucket_ALL_code_output_other	/minimax-dialogue/data/users/Dan/code/projects/m2_distribution/data/m2_cc_with_code_math_after_clean/plain/batch_*/other/code_output/bucket_*/*.jsonl
CC-bucket_ALL_math_output_en	/minimax-dialogue/data/users/Dan/code/projects/m2_distribution/data/m2_cc_with_code_math_after_clean/plain/batch_*/en/math_output/bucket_*/*.jsonl
CC-bucket_ALL_math_output_ml	/minimax-dialogue/data/users/Dan/code/projects/m2_distribution/data/m2_cc_with_code_math_after_clean/plain/batch_*/ml/math_output/bucket_*/*.jsonl
CC-bucket_ALL_math_output_other	/minimax-dialogue/data/users/Dan/code/projects/m2_distribution/data/m2_cc_with_code_math_after_clean/plain/batch_*/other/math_output/bucket_*/*.jsonl
CC-bucket_ALL_math_output_zh	/minimax-dialogue/data/users/Dan/code/projects/m2_distribution/data/m2_cc_with_code_math_after_clean/plain/batch_*/zh/math_output/bucket_*/*.jsonl